R 500 500
NO ./textures/north.xpm
SO ./textures/south.xpm
WE ./textures/west.xpm
EA ./textures/east.xpm
S ./sprite/sprite1.xpm
F 220    ,  100,0  
C 225,30,0

      11111111
      10000001
      10000W0111111
      1000000000001
1111111002000111101
10000000000001  101
10000000000001  111
10002000000201
10000000011111
1000000001
1111111111